+-------------------------+
|...............()........|
|..*......................| 
|.........................|
|.................~~~~....| 
|.++++++++................|
|.........................|
|.......^^^^^^^^^^........|
|..........*..............|
|.........................|
|.......+++++++++.........|
|.........................|
|.........................|
|....~~~..............*...|
|...~~~~~.................|
|.....~~~~~...............|
|..~~~~~~.................|
|.....................+++.|
|.........................|
|.........................|
|.........................|
|..().....................|
+-------------------------+